#####################
#$$$$$$$$$$$$$$$$$$$#
#$                  #
#$    +++++++       #
#$    ++    ++      #
#$    ++    ++      #
#$    ++++++++      #
#$    ++++++++      #
#$    ++     ++     #
#$    ++      ++    #
#$    ++     +++    #
#$    +++++++++     #
#$                  #
#$$$$$$$$$$$$$$$$$$$#
#####################
